男	男 ♂
雄性	雄性 ♂
女	女 ♀
雌性	雌性 ♀
双性	双性 ⚥
相交	相交 ⚭
相切	相切 ⚮
相离	相离 ⚯
音调	音调 ♭ ♮ ♯
重点	重点 ※
四边形	四边形 ⎕ ⏥
平行四边形	平行四边形 ⏥
六边形	六边形 ⎔
度	度 ° ℃ ℉
分	分 ′
秒	秒 〃 ㎳ ㎲ ㎱ ㎰
黑桃	黑桃 ♠ ♤
红桃	红桃 ♥ ♡
方片	方片 ♦ ♢
梅花	梅花 ♣ ♧
共产党	共产党 ☭
党	党 ☭
共产主义	共产主义 ☭
国民党	国民党 ❂
社会主义核心价值观	社会主义核心价值观 富强、民主、文明、和谐、自由、平等、公正、法治、爱国、敬业、诚信、友善 富强 民主 文明 和谐 自由 平等 公正 法治 爱国 敬业 诚信 友善
八荣八耻	八荣八耻 社会主义荣辱观 以热爱祖国为荣，以危害祖国为耻；以服务人民为荣，以背离人民为耻；以崇尚科学为荣，以愚昧无知为耻；以辛勤劳动为荣，以好逸恶劳为耻；以团结互助为荣，以损人利己为耻；以诚实守信为荣，以见利忘义为耻；以遵纪守法为荣，以违法乱纪为耻；以艰苦奋斗为荣，以骄奢淫逸为耻。
质量	质量 ㎏ ㎎ ㎍
克	克 ㎏ ㎎ ㎍
距离	距离 ㎞ ㎝ ㎜ ㎛ ㎚ ㎙
长度	长度 ㎞ ㎝ ㎜ ㎛ ㎚ ㎙
米	米 ㎝ ㎞ ㎜ ㎙ ㎚ ㎛
弧度	弧度 ㎭ ㎮ ㎯
时间	时间 ㎳ ㎲ ㎱ ㎰
面积	面积 ㎢ ㎡ ㎠ ㎟
体积	体积 ㎥ ㎦ ㎤ ㎣ ㎕ ㎖ ㎗ ㎘
电流	电流 ㎀ ㎁ ㎂ ㎃ ㎄
安	安 ㎀ ㎁ ㎂ ㎃ ㎄
安培	安培 ㎀ ㎁ ㎂ ㎃ ㎄
容量	容量 ㎕ ㎖ ㎗ ㎘
升	升 ㎖ ㎕ ㎗ ㎘
频率	频率 ㎐ ㎑ ㎒ ㎓ ㎔
赫兹	赫兹 ㎐ ㎑ ㎒ ㎓ ㎔
速度	速度 ㎧
加速度	加速度 ㎨
压强	压强 ㎩ ㍱ ㎪ ㎫ ㎬
压力	压力 ㎩ ㍱ ㎪ ㎫ ㎬
帕	帕 ㎩ ㍱ ㎪ ㎫ ㎬
帕斯卡	帕斯卡 ㎩ ㍱ ㎪ ㎫ ㎬
电压	电压 ㎴ ㎵ ㎶ ㎷ ㎸ ㎹
伏	伏 ㎴ ㎵ ㎶ ㎷ ㎸ ㎹
伏特	伏特 ㎴ ㎵ ㎶ ㎷ ㎸ ㎹
功率	功率 ㎺ ㎻ ㎼ ㎽ ㎾ ㎿
瓦	瓦 ㎺ ㎻ ㎼ ㎽ ㎾ ㎿
瓦特	瓦特 ㎺ ㎻ ㎼ ㎽ ㎾ ㎿
电阻	电阻 ㏀ ㏁
欧	欧 ㏀ ㏁
欧姆	欧姆 ㏀ ㏁
电容	电容 ㎊ ㎋ ㎌
法拉	法拉 ㎊ ㎋ ㎌
字节	字节 ㎅ ㎆ ㎇
对数	对数 ㏑ ㏒
摩尔	摩尔 ㏖
分贝	分贝 ㏈
平方米	平方米 ㎡
英里	英里 ㏕
纳米	纳米 ㎚
微米	微米 ㎛
毫米	毫米 ㎜
厘米	厘米 ㎝
千米	千米 ㎞ ㏎
立方米	立方米 m³
毫克	毫克 ㎎
千克	千克 ㎏
积分	积分 ∫ ∬ ∭ ∮ ∯ ∰ ⨌
零	零 〇 ⁰ ₀ ⓪ 𝟘 ⓿ 0️⃣
一	一 壹 Ⅰ ⅰ ¹ ₁ ① 🈩 ⓵ 𝟙 ⒈ ➊ ㊀ ㈠ 1️⃣ 𓃉
二	二 贰 Ⅱ ⅱ ² ₂ ② 🈔 ⓶ 𝟚 ⒉ ➋ ㊁ ㈡ 2️⃣ 𓃊
三	三 叁 Ⅲ ⅲ ³ ₃ ③ 🈪 ⓷ 𝟛 ⒊ ➌ ㊂ ㈢ 3️⃣ 𓃋
四	四 肆 Ⅳ ⅳ ⁴ ₄ ④ ⓸ 𝟜 ⒋ ➍ ㊃ ㈣ 4️⃣ 𓃌
五	五 伍 Ⅴ ⅴ ⁵ ₅ ⑤ ⓹ 𝟝 ⒌ ➎ ㊄ ㈤ 5️⃣ 𓃍
六	六 陆 Ⅵ ⅵ ⁶ ₆ ⑥ ⓺ 𝟞 ⒍ ➏ ㊅ ㈥ 6️⃣ 𓃎
七	七 柒 Ⅶ ⅶ ⁷ ₇ ⑦ ⓻ 𝟟 ⒎ ➐ ㊆ ㈦ 7️⃣ 𓃏
八	八 捌 Ⅷ ⅷ ⁸ ₈ ⑧ ⓼ 𝟠 ⒏ ➑ ㊇ ㈧ 8️⃣ 𓃐
九	九 玖 Ⅸ ⅸ ⁹ ₉ ⑨ ⓽ 𝟡 ⒐ ➒ ㊈ ㈨ 9️⃣ 𓃑
十	十 拾 Ⅹ ⅹ ⑩ ⓾ ⒑ ➓ ㊉ ㈩ 🔟
百	百 佰
千	千 仟
十一	十一 Ⅺ ⅺ ⑪
十二	十二 Ⅻ ⅻ  ⑫
根号	根号 √ ∛ ∜
加减	加减 ± ∓
和	和 ∑ ∧
除	除 ÷
求和	求和 ∑
圆周率	圆周率 π
卡路里	卡路里 ㎈ ㎉
梯度	梯度 ∇
旋度	旋度 ∇×
散度	散度 ∇·
拉普拉斯	拉普拉斯 ∇² ∇·∇
拉普拉斯算符	拉普拉斯算符 ∇² ∇·∇
达朗贝尔	达朗贝尔 ☐²
达朗贝尔算符	达朗贝尔算符 ☐²
属于	属于 ∈ ∉ ∊ ∋ ∌ ∍
正比	正比 ∝
角	角 ∠
空	空 ∅
空集	空集 ∅
包含	包含 ⊂ ⊃ ⊆ ⊇
并	并 ∪
交	交 🈘 ∩
或	或 ∨
反	反 ¬
逆	逆 ¬
并集	并集 ∪
交集	交集 ∩
因为	因为 ∵
所以	所以 ∴
阶乘	阶乘 !
直和	直和 ⊕
直积	直积 ⊗
章节	章节 §
节	节 §
段落	段落 ¶ ⁋
段	段 ¶ ⁋
等于	等于 = ≈ ≅ ≠ ⁼ ₌ ≡ ⇔ ↔ ↕
全等	全等 ≅
小于	小于 < ≤ ≪
大于	大于 > ≥ ≫
远小于	远小于 ≪
远大于	远大于 ≫
小于等于	小于等于 ≤
大于等于	大于等于 ≥
不等于	不等于 ≠
不等	不等 ≠
任意	任意 ∀
存在	存在 ∃ ∄
星	星 ✳ ✴ ❇ ⍟
千分	千分 ‰
万分	万分 ‱
万	万 卍 卐
纳粹	纳粹 卐
埃	埃 Åa
五行	五行 ㊎ ㊍ ㊌ ㊋ ㊏
正	正 ㊣
祝	祝 ㊗ ㈷
秘	秘 ㊙
木	木 ㊍ ㈭
金	金 ㊎ ㈮
土	土 ㊏ ㈯
株	株 ㊑ ㈱
社	社 ㊓ ㈳
名	名 ㊔ ㈴
特	特 ㊕ ㈵
财	财 ㊖ ㈶
劳	劳 ㊘ ㈸
代	代 ㈹
呼	呼 ㈺
適	適 ㊜
优	优 ㊝
印	印 ㊞
注	注 ㊟
项	项 ㊠
休	休 ㊡ ㉁
自	自 ㉂
至	至 ㉃
中	中 ㊥ 🈭
医	医 ㊩
宗	宗 ㊪
学	学 ㊫ ㈻
监	监 ㊬ ㈼
资	资 ㊮ ㈾
协	协 ㊯ ㈿
祭	祭 ㉀
字	字 🈑
双	双 🈒
多	多 🈕
解	解 🈖
天	天 🈗
映	映 🈙
料	料 🈛
再	再 🈞
初	初 🈠
终	终 🈡
生	生 🈢
贩	贩 🈣
声	声 🈤
演	演 🈦
打	打 🈱
投	投 🈧
捕	捕 🈨
游	游 🈫
幼	幼 ㉅
文	文 ㉆
筝	筝 ㉇
国际音标	国际音标 ɐ ɑ ɒ ɓ ɔ ɕ ɖ ɗ ɘ ə ɚ ɛ ɜ ɝ ɞ ɟ ɠ ɡ ɢ ɣ ɤ ɥ ɦ ɧ ɨ ɩ ɪ ɫ ɬ ɭ ɮ ɯ ɰ ɱ ɲ ɳ ɴ ɵ ɶ ɷ ɸ ɹ ɺ ɻ ɼ ɽ ɾ ɿ ʀ ʁ ʂ ʃ ʄ ʅ ʆ ʇ ʈ ʉ ʊ ʋ ʌ ʍ ʎ ʏ ʐ ʑ ʒ ʓ ʔ ʕ ʖ ʗ ʘ ʙ ʚ ʛ ʜ ʝ ʞ ʟ ʠ ʡ ʢ ʣ ʤ ʥ ʦ ʧ ʨ ʩ ʪ ʫ ʬ ʭ ʮ
罗马数字	罗马数字 ⅰ ⅱ ⅲ ⅳ ⅴ ⅵ ⅶ ⅷ ⅸ ⅹ ⅺ ⅻ ⅼ ⅽ ⅾ ⅿ Ⅰ Ⅱ Ⅲ Ⅳ Ⅴ Ⅵ Ⅶ Ⅷ Ⅸ Ⅹ Ⅺ Ⅻ Ⅼ Ⅽ Ⅾ Ⅿ
结构	结构 ⿰ ⿱ ⿲ ⿳ ⿴ ⿵ ⿶ ⿷ ⿸ ⿹ ⿺ ⿻ 〾
分数	分数 ½ ⅓ ⅔ ¼ ¾ ⅕ ⅖ ⅗ ⅘ ⅙ ⅚ ⅐ ⅛ ⅜ ⅝ ⅞ ⅑ ⅒ ⅟ ↉ ℀ ℁ ℅ ℆ ⅍
音标	音标 i: ɜ: ɑ: ɔ: u: ɪ e æ ʌ ɒ ʊ ə eɪ aɪ ɔɪ əʊ aʊ ɪə eə ʊə p t k f θ s ʃ h tʃ ts tr b d g v ð z ʒ r dʒ dz dr j w m n ŋ l
注音	注音 ㄅ ㄆ ㄇ ㄈ ㄉ ㄊ ㄋ ㄌ ㄍ ㄎ ㄏ ㄐ ㄑ ㄒ ㄓ ㄔ ㄕ ㄖ ㄗ ㄘ ㄙ ㄚ ㄛ ㄜ ㄝ ㄞ ㄟ ㄠ ㄡ ㄢ ㄣ ㄤ ㄥ ㄦ ㄧ 丨 ㄨ ㄩ
部首	部首 一 丨 丿 丶 乛 乚 匚 刂 冂 亻 丷 勹 亠 冫 冖 讠 卩 阝 凵 厶 廴 扌 艹 廾 尢 囗 彳 彡 犭 夂 饣 忄 氵 宀 辶 彐 彑 巳 孑 屮 纟 幺 巛 攴 牜 攵 爫 殳 灬 礻 肀 爿 氺 罒 钅 疒 衤 疋 癶 耒 虍 糸 豸 隹
横	横 一
竖	竖 丨
撇	撇 丿
捺	捺 丶
折	折 乛 乚
笔划	笔划 ㇀ ㇁ ㇂ ㇃ ㇄ ㇅ ㇆ ㇇ ㇈ ㇉ ㇊ ㇋ ㇌ ㇍ ㇎ ㇏ ㇐ ㇑ ㇒ ㇓ ㇔ ㇕ ㇖ ㇗ ㇘ ㇙ ㇚ ㇛ ㇜ ㇝ ㇞ ㇟ ㇠ ㇡ ㇢ ㇣
平假名	平假名 あ い う え お ぁ ぃ ぅ ぇ ぉ か き く け こ が ぎ ぐ げ ご さ し す せ そ ざ じ ず ぜ ぞ た ち つ て と だ ぢ づ で ど っ な に ぬ ね の は ひ ふ へ ほ ば び ぶ べ ぼ ぱ ぴ ぷ ぺ ぽ ま み む め も や ゆ よ ゃ ゅ ょ ら り る れ ろ わ を ん ゎ
片假名	片假名 ア イ ウ エ オ ァ ィ ゥ ェ ォ カ キ ク ケ コ ガ ギ グ ゲ ゴ サ シ ス セ ソ ザ ジ ズ ゼ ゾ タ チ ツ テ ト ダ ヂ ヅ デ ド ッ ナ ニ ヌ ネ ノ ハ ヒ フ ヘ ホ バ ビ ブ ベ ボ パ ピ プ ペ ポ マ ミ ム メ モ ャ ヤ ュ ユ ョ ヨ ラ リ ル レ ロ ワ ヰ ヱ ヲ ン ヴ ヵ ヶ ー
韩语	韩语 ㄱ ㄲ ㄳ ㄴ ㄵ ㄶ ㄷ ㄸ ㄹ ㄺ ㄻ ㄼ ㄽ ㄾ ㄿ ㅀ ㅁ ㅂ ㅃ ㅄ ㅅ ㅆ ㅇ ㅈ ㅉ ㅊ ㅋ ㅌ ㅍ ㅎ ㅏ ㅐ ㅑ ㅒ ㅓ ㅔ ㅕ ㅖ ㅗ ㅘ ㅙ ㅚ ㅛ ㅜ ㅝ ㅞ ㅟ ㅠ ㅡ ㅢ ㅥ ㅦ ㅧ ㅨ ㅩ ㅪ ㅫ ㅬ ㅭ ㅮ ㅯ ㅰ ㅱ ㅲ ㅳ ㅴ ㅵ ㅶ ㅷ ㅸ ㅹ ㅺ ㅻ ㅼ ㅽ ㅾ ㅿ ㆀ ㆁ ㆂ ㆃ ㆄ ㆅ ㆆ ㆇ ㆈ ㆉ ㆊ
俄语	俄语 а б в г д е ё ж з и й к л м н о п р с т у ф х ц ч ш щ ъ ы ь э ю я А Б В Г Д Е Ё Ж З И Й К Л М Н О П Р С Т У Ф Х Ц Ч Ш Щ Ъ Ы Ь Э Ю Я
元素	元素 氢H 氦He 锂Li 铍Be 硼B 碳C 氮N 氧O 氟F 氖Ne 钠Na 镁Mg 铝Al 硅Si 磷P 硫S 氯Cl 氩Ar 钾K 钙Ca 钪Sc 钛Ti 钒V 铬Cr 锰Mn 铁Fe 钴Co 镍Ni 铜Cu 锌Zn 镓Ga 锗Ge 砷As 硒Se 溴Br 氪Kr 铷Rb 锶Sr 钇Y 锆Zr 铌Nb 钼Mo 锝Tc 钌Ru 铑Rh 钯Pd 银Ag 镉Cd 铟In 锡Sn 锑Sb 碲Te 碘I 氙Xe 铯Cs 钡Ba 镧La 铈Ce 镨Pr 钕Nd 钷Pm 钐Sm 铕Eu 钆Gd 铽Tb 镝Dy 钬Ho 铒Er 铥Tm 镱Yb 镥Lu 铪Hf 钽Ta 钨W 铼Re 锇Os 铱Ir 铂Pt 金Au 汞Hg 铊Tl 铅Pb 铋Bi 钋Po 砹At 氡Rn 钫Fr 镭Ra 锕Ac 钍Th 镤Pa 铀U 镎Np 钚Pu 镅Am 锔Cm 锫Bk 锎Cf 锿Es 镄Fm 钔Md 锘No 铹Lr 𬬻Rf 𬭊Db 𬭳Sg 𬭛Bh 𬭶Hs 鿏Mt 𫟼Ds 𬬭Rg 鿔Cn 鿭Nh 𫓧Fl 镆Mc 𫟷Lv 鿬Ts 鿫Og
象形文字	象形文字 𓀀 𓀁 𓀂 𓀃 𓀄 𓀅 𓀆 𓀇 𓀈 𓀉 𓀊 𓀋 𓀌 𓀍 𓀎 𓀏 𓀐 𓀑 𓀒 𓀓 𓀔 𓀕 𓀖 𓀗 𓀘 𓀙 𓀚 𓀛 𓀜 𓀝 𓀞 𓀟 𓀠 𓀡 𓀢 𓀣 𓀤 𓀥 𓀦 𓀧 𓀨 𓀩 𓀪 𓀫 𓀬 𓀻 𓀼 𓀽 𓀾 𓀿 𓁀 𓁁 𓁂 𓁃 𓁄 𓁅 𓁆 𓁇 𓁈 𓁉 𓁟 𓁠 𓁩 𓁶 𓁷 𓃒 𓃗 𓃘 𓃝 𓃟 𓃠 𓃡 𓃩 𓃬 𓃯 𓃰 𓃱 𓃲 𓃵 𓃷 𓃻 𓅜 𓅦 𓅪 𓅭 𓅰 𓆟 𓆡 𓆏 𓃭 𓃹 𓃾 𓄿 𓆂 𓅓 𓅔 𓅡 𓅡 𓅬 𓅱 𓅿 𓆈 𓆉 𓆊 𓆌 𓆋 𓆐 𓆑 𓆓 𓆕 𓆗 𓆙 𓆚 𓆞 𓆣 𓆤 𓆦 𓆧 𓆨 𓆫 𓆱 𓇳 𓇹 𓊛
制表	制表 ─ ━ │ ┃ ┄ ┅ ┆ ┇ ┈ ┉ ┊ ┋ ┌ ┍ ┎ ┏ ┐ ┑ ┒ ┓ └ ┕ ┖ ┗ ┘ ┙ ┚ ┛ ├ ┝ ┞ ┟ ┠ ┡ ┢ ┣ ┤ ┥ ┦ ┧ ┨ ┩ ┪ ┫ ┬ ┭ ┮ ┯ ┰ ┱ ┲ ┳ ┴ ┵ ┶ ┷ ┸ ┹ ┶ ┻ ┼ ┽ ┾ ┿ ╀ ╁ ╂ ╃ ╄ ╅ ╆ ╇ ╈ ╉ ╊ ╋ ═ ║ ╒ ╓ ╔ ╕ ╖ ╗ ╘ ╙ ╚ ╛ ╜ ╝ ╞ ╟ ╠ ╡ ╢ ╣ ╤ ╥ ╦ ╧ ╨ ╩ ╪ ╫ ╬ ╭ ╮ ╯ ╰ ╱ ╲ ╳
无穷	无穷 ♾ ∞	∞ -∞
二十八宿	二十八宿 东苍龙 北玄武 西白虎 南朱雀
苍龙	苍龙 角 亢 氐 房 心 尾 箕
玄武	玄武 斗 牛 女 虚 危 室 壁
白虎	白虎 奎 娄 胃 昴 毕 觜 参
朱雀	朱雀 井 鬼 柳 星 张 翼 轸
二十八星宿	二十八星宿 角木蛟 亢金龙 氐土貉 房日兔 心月狐 尾火虎 箕水豹 斗木獬 牛金牛 女土蝠 虚日鼠 危月燕 室火猪 壁水貐 奎木狼 娄金狗 胃土雉 昴日鸡 毕月乌 觜火猴 参水猿 井木犴 井木犴 鬼金羊 柳土獐 星日马 张月鹿 翌火蛇 轸水蚓
八卦	八卦 ☯ ☰ ☱ ☲ ☳ ☷ ☶ ☵ ☴ 天乾☰ 泽兑☱ 火离☲ 雷震☳ 地坤☷ 山艮☶ 水坎☵ 风巽☴
乾	乾 ☰
兑	兑 ☱
离	离 ☲
震	震 ☳
坤	坤 ☷
艮	艮 ☶
坎	坎 ☵
巽	巽 ☴
六十四卦	六十四卦 ䷀ ䷁ ䷂ ䷃ ䷄ ䷅ ䷆ ䷇ ䷈ ䷉ ䷊ ䷋ ䷌ ䷍ ䷎ ䷏ ䷐ ䷑ ䷒ ䷓ ䷔ ䷕ ䷖ ䷗ ䷘ ䷙ ䷚ ䷛ ䷜ ䷝ ䷞ ䷟ ䷠ ䷡ ䷢ ䷣ ䷤ ䷥ ䷦ ䷧ ䷨ ䷩ ䷪ ䷫ ䷬ ䷭ ䷮ ䷯ ䷰ ䷱ ䷲ ䷳ ䷴ ䷵ ䷶ ䷷ ䷸ ䷹ ䷺ ䷻ ䷼ ䷽ ䷾ ䷿
天干	天干 甲 乙 丙 丁 戊 己 庚 辛 壬 癸
地支	地支 子 丑 寅 卯 辰 巳 午 未 申 酉 戌 亥
节气	节气 立春 雨水 惊蛰 春分 清明 谷雨 立夏 小满 芒种 夏至 小暑 大暑 立秋 处暑 白露 秋分 寒露 霜降 立冬 小雪 大雪 冬至 小寒 大寒
三字经	三字经 人之初 性本善 性相近 习相远 苟不教 性乃迁 教之道 贵以专 昔孟母 择邻处 子不学 断机杼 窦燕山 有义方 教五子 名俱扬 养不教 父之过 教不严 师之惰 子不学 非所宜 幼不学 老何为 玉不琢 不成器 人不学 不知义 为人子 方少时 亲师友 习礼仪 香九龄 能温席 孝于亲 所当执 融四岁 能让梨 弟于长 宜先知 首孝弟 次见闻 知某数 识某文 一而十 十而百 百而千 千而万 三才者 天地人 三光者 日月星 三纲者 君臣义 父子亲 夫妇顺 曰春夏 曰秋冬 此四时 运不穷 曰南北 曰西东 此四方 应乎中 曰水火 木金土 此五行 本乎数 曰仁义 礼智信 此五常 不容紊 稻粱菽 麦黍稷 此六谷 人所食 马牛羊 鸡犬豕 此六畜 人所饲 曰喜怒 曰哀惧 爱恶欲 七情具 匏土革 木石金 丝与竹 乃八音 高曾祖 父而身 身而子 子而孙 自子孙 至玄曾 乃九族 人之伦 父子恩 夫妇从 兄则友 弟则恭 长幼序 友与朋 君则敬 臣则忠 此十义 人所同 凡训蒙 须讲究 详训诂 明句读 为学者 必有初 小学终 至四书 论语者 二十篇 群弟子 记善言 孟子者 七篇止 讲道德 说仁义 作中庸 子思笔 中不偏 庸不易 作大学 乃曾子 自脩齐 至平治 孝经通 四书熟 如六经 始可读 诗书易 礼春秋 号六经 当讲求 有连山 有归藏 有周易 三易详 有典谟 有训诰 有誓命 书之奥 我周公 作周礼 著六官 存治体 大小戴 注礼记 述圣言 礼乐备 曰国风 曰雅颂 号四诗 当讽咏 诗既亡 春秋作 寓褒贬 别善恶 三传者 有公羊 有左氏 有谷梁 经既明 方读子 撮其要 记其事 五子者 有荀杨 文中子 及老庄 经子通 读诸史 考世系 知终始 自羲农 至黄帝 号三皇 居上世 唐有虞 号二帝 相揖逊 称盛世 夏有禹 商有汤 周文武 称三王 夏传子 家天下 四百载 迁夏社 汤伐夏 国号商 六百载 至纣亡 周武王 始诛纣 八百载 最长久 周辙东 王纲坠 逞干戈 尚游说 始春秋 终战国 五霸强 七雄出 嬴秦氏 始兼并 传二世 楚汉争 高祖兴 汉业建 至孝平 王莽篡 光武兴 为东汉 四百年 终于献 魏蜀吴 争汉鼎 号三国 迄两晋 宋齐继 梁陈承 为南朝 都金陵 北元魏 分东西 宇文周 与高齐 迨至隋 一土宇 不再传 失统绪 唐高祖 起义师 除隋乱 创国基 二十传 三百载 梁灭之 国乃改 梁唐晋 及汉周 称五代 皆有由 炎宋兴 受周禅 十八传 南北混 十七史 全在兹 载治乱 知兴衰 读史者 考实录 通古今 若亲目 口而诵 心而惟 朝于斯 夕于斯 昔仲尼 师项橐 古圣贤 尚勤学 赵中令 读鲁论 彼既仕 学且勤 披蒲编 削竹简 彼无书 且知勉 头悬梁 锥刺股 彼不教 自勤苦 如囊萤 如映雪 家虽贫 学不辍 如负薪 如挂角 身虽劳 犹苦卓 蘇老泉 二十七 始发愤 读书籍 彼既老 犹悔迟 尔小生 宜早思 若梁灝 八十二 对大廷 魁多士 彼既成 众称异 尔小生 宜立志 莹八岁 能咏诗 泌七岁 能赋碁 彼颖悟 人称奇 尔幼学 当效之 蔡文姬 能辨琴 谢道韫 能咏吟 彼女子 且聪敏 尔男子 当自警 唐刘晏 方七岁 举神童 作正字 彼虽幼 身己仕 尔幼学 勉而致 有为者 亦若是 犬守夜 鸡司晨 苟不学 曷为人 蚕吐丝 蜂酿蜜 人不学 不如物 幼而学 壮而行 上致君 下泽民 扬名声 显父母 光于前 裕于後 人遗子 金满籯 我教子 惟一经 勤有功 戏无益 戒之哉 宜勉力
百家姓	百家姓 赵钱孙李 周吴郑王 冯陈褚卫 蒋沈韩杨 朱秦尤许 何吕施张 孔曹严华 金魏陶姜 戚谢邹喻 柏水窦章 云苏潘葛 奚范彭郎 鲁韦昌马 苗凤花方 俞任袁柳 酆鲍史唐 费廉岑薛 雷贺倪汤 滕殷罗毕 郝邬安常 乐于时傅 皮卞齐康 伍余元卜 顾孟平黄 和穆萧尹 姚邵湛汪 祁毛禹狄 米贝明臧 计伏成戴 谈宋茅庞 熊纪舒屈 项祝董梁 杜阮蓝闵 席季麻强 贾路娄危 江童颜郭 梅盛林刁 钟徐邱骆 高夏蔡田 樊胡凌霍 虞万支柯 昝管卢莫 经房裘缪 干解应宗 丁宣贲邓 郁单杭洪 包诸左石 崔吉钮龚 程嵇邢滑 裴陆荣翁 荀羊於惠 甄曲家封 芮羿储靳 汲邴糜松 井段富巫 乌焦巴弓 牧隗山谷 车侯宓蓬 全郗班仰 秋仲伊宫 宁仇栾暴 甘钭厉戎 祖武符刘 景詹束龙 叶幸司韶 郜黎蓟薄 印宿白怀 蒲邰从鄂 索咸籍赖 卓蔺屠蒙 池乔阴鬱 胥能苍双 闻莘党翟 谭贡劳逄 姬申扶堵 冉宰郦雍 卻璩桑桂 濮牛寿通 边扈燕冀 郏浦尚农 温别庄晏 柴瞿阎充 慕连茹习 宦艾鱼容 向古易慎 戈廖庾终 暨居衡步 都耿满弘 匡国文寇 广禄阙东 欧殳沃利 蔚越夔隆 师巩厍聂 晁勾敖融 冷訾辛阚 那简饶空 曾毋沙乜 养鞠须丰 巢关蒯相 查后荆红 游竺权逯 盖益桓公 万俟司马 上官欧阳 夏侯诸葛 闻人东方 赫连皇甫 尉迟公羊 澹台公冶 宗政濮阳 淳于单于 太叔申屠 公孙仲孙 轩辕令狐 钟离宇文 长孙慕容 鲜于闾丘 司徒司空 丌官司寇 仉督子车 颛孙端木 巫马公西 漆雕乐正 壤驷公良 拓跋夹谷 宰父谷梁 晋楚闫法 汝鄢涂钦 段干百里 东郭南门 呼延归海 羊舌微生 岳帅缑亢 况郈有琴 梁丘左丘 东门西门 商牟佘佴 伯赏南宫 墨哈谯笪 年爱阳佟 第五言福 百家姓终
千字文	千字文 天地玄黄 宇宙洪荒 日月盈昃 辰宿列张 寒来暑往 秋收冬藏 闰余成岁 律吕调阳 云腾致雨 露结为霜 金生丽水 玉出昆岗 剑号巨阙 珠称夜光 果珍李柰 菜重芥姜 海咸河淡 鳞潜羽翔 龙师火帝 鸟官人皇 始制文字 乃服衣裳 推位让国 有虞陶唐 吊民伐罪 周发殷汤 坐朝问道 垂拱平章 爱育黎首 臣伏戎羌 遐迩一体 帅宾归王 鸣凤在竹 白驹食场 化被草木 赖及万方 盖此身发 四大五常 恭惟鞠养 岂敢毁伤 女慕贞洁 男效才良 知过必改 得能莫忘 罔谈彼短 靡恃己长 信使可复 器欲难量 墨悲丝染 诗赞羔羊 景行维贤 克念作圣 德建名立 形端表正 空谷传声 虚堂习听 祸因恶积 福缘善庆 尺璧非宝 寸阴是竞 资父事君 曰严与敬 孝当竭力 忠则尽命 临深履薄 夙兴温凊 似兰斯馨 如松之盛 川流不息 渊澄取映 容止若思 言辞安定 笃初诚美 慎终宜令 荣业所基 籍甚无竟 学优登仕 摄职从政 存以甘棠 去而益咏 乐殊贵贱 礼别尊卑 上和下睦 夫唱妇随 外受傅训 入奉母仪 诸姑伯叔 犹子比儿 孔怀兄弟 同气连枝 交友投分 切磨箴规 仁慈隐恻 造次弗离 节义廉退 颠沛匪亏 性静情逸 心动神疲 守真志满 逐物意移 坚持雅操 好爵自縻 都邑华夏 东西二京 背邙面洛 浮渭据泾 宫殿盘郁 楼观飞惊 图写禽兽 画彩仙灵 丙舍旁启 甲帐对楹 肆筵设席 鼓瑟吹笙 升阶纳陛 弁转疑星 右通广内 左达承明 既集坟典 亦聚群英 杜稿钟隶 漆书壁经 府罗将相 路侠槐卿 户封八县 家给千兵 高冠陪辇 驱毂振缨 世禄侈富 车驾肥轻 策功茂实 勒碑刻铭 盘溪伊尹 佐时阿衡 奄宅曲阜 微旦孰营 桓公匡合 济弱扶倾 绮回汉惠 说感武丁 俊乂密勿 多士是宁 晋楚更霸 赵魏困横 假途灭虢 践土会盟 何遵约法 韩弊烦刑 起翦颇牧 用兵最精 宣威沙漠 驰誉丹青 九州禹迹 百郡秦并 岳宗泰岱 禅主云亭 雁门紫塞 鸡田赤城 昆池碣石 钜野洞庭 旷远绵邈 岩岫杳冥 治本于农 务资稼穑 俶载南亩 我艺黍稷 税熟贡新 劝赏黜陟 孟轲敦素 史鱼秉直 庶几中庸 劳谦谨敕 聆音察理 鉴貌辨色 贻厥嘉猷 勉其祗植 省躬讥诫 宠增抗极 殆辱近耻 林皋幸即 两疏见机 解组谁逼 索居闲处 沉默寂寥 求古训论 散虑逍遥 欣奏累遣 戚谢欢招 渠荷的历 园莽抽条 枇杷晚翠 梧桐蚤凋 陈根委翳 落叶飘摇 游鹍独运 凌摩绛霄 耽读玩市 寓目囊箱 易輶攸畏 属耳垣墙 具膳餐饭 适口充肠 饱饫烹宰 饥厌糟糠 亲戚故旧 老少异粮 妾御绩纺 侍巾帷房 纨扇圆洁 银烛炜煌 昼眠夕寐 蓝笋象床 弦歌酒宴 接杯举觞 矫手顿足 悦豫且康 嫡后嗣续 祭祀烝尝 稽颡再拜 悚惧恐慌 笺牒简要 顾答审详 骸垢想浴 执热愿凉 驴骡犊特 骇跃超骧 诛斩贼盗 捕获叛亡 布射僚丸 嵇琴阮啸 恬笔伦纸 钧巧任钓 释纷利俗 并皆佳妙 毛施淑姿 工颦妍笑 年矢每催 曦晖朗曜 旋即斡旋 晦魄环照 指薪修祜 永绥吉劭 矩步引领 俯仰廊庙 束带矜庄 徘徊瞻眺 孤陋寡闻 愚蒙等诮 谓语助者 焉哉乎也
